###################
#00000000#00000000#
#f##0###0#0###0##f#
#00000000000000000#
#0##0#0#####0#0##0#
#0000#000#000#0000#
####0### # ###0####
   #0#   R   #0#
   #0# ## ## #0#
   #0  #BOI#  0#
   #0# ##### #0#
   #0#       #0#
####0# ##### #0####
#00000000#00000000#
#0##0###0#0###0##0#
#f0#00000P00000#0f#
##0#0#0#####0#0#0##
#0000#000#000#0000#
#0######0#0######0#
#00000000000000000#
###################